111111111111111111111111111111111111111111111111
111111111111111111111111111111111111111111111111
1111110000000000000L00000N00000000000000P1100111
1110000000111111000000000000010111110000000N0011
11000000011111111000000N000011111010100000000011
1100000001111111000B0000000001111000011010000111
11100B000111111110000000000111111100000000000011
110000000111111000000B000000010000000000E0000011
10000000000000000B00000000000000N000000000000011
111111111111111111111111111111111111111111111111
111111111111111111111111111111111111100000000011
111111111111111111111111111111111111100000F00E11
111111111111111111111111111111111111100000000011
111111111111111111111111111111111111111111111111