11111111111111111111111111111111111111111111111
11111111111111111111111111111111111111111111111
1111110000000000000000000000000000000000P110011
1110000000111111000000000000010111110000000N001
11000000011111111000000000001111101010000000001
11000000011111110000000000000111100001101000011
11100000011111111000000000011111110000000000001
11000000011111100000000000000100000000000000001
10000000000000000000000000000000000000000000001
11111111111111111111111111111111111111111111111
11111111111111111111111111111111111110000000001
111111111111111111111111111111111111100000F00E1
11111111111111111111111111111111111110000000001
11111111111111111111111111111111111111111111111

1 = Wall
0 = Floor
P = Player
E = Enemy
F = Fire

EXIT??